XXXXXXXXXXXXXXXXXXXX
Xa11231112222111112X
X111191221111211122X
X211223311112112211X
XX1112233221123XXXXX
XXXX112333122211XXXX
XXXXXXX1X122XXXc111X
XbXXXXXXX111223311XX
XX11123341112211122X
X111233212312311111X
XXXXXXXXXXXXXX11221X
X11221111111111XXXXX
Xd111222111223311XXX
X111111111111111111X
X233123123344122211X
X123112XXXXXXX11231X
X12321112312312312XX
X1111111232111XXXXXX
XXXXXXXX1123411111eX
XXXXXXXXXXXXXXXXXXXX